#########
#.......#
#.## ##.#
 .#...#. 
#.1 @ 2.#
 .#...#. 
#.## ##.#
#.......#
#########